n n n n n n n n n n n n n n n n n N n n n n n n n n n n n n n n n n n n
n n n n n n n n n n n n n n n n n n n 7 n n n n n n 1 n n n n 6 n n n n
n n n 2 n n 8 n n n n n n n n n n n n 4 n n n n n n n n n 8 n n n n 9 n
n n n n n n n n n n n n 1 n n n n n n n n n n n 7 n n n n n n n n 5 n n
n 8 n n n n n n n n n n n n n 5 n n n n 3 n n n 4 n n n n n n n n n n n
n n n n n n n n n n n n n 0 n n n n n n n n n n n n n n n n n 1 n n N n
n n n n n n n n n n n n n n n n n n n n n n 0 n n n n n n n n n n n n n
n n n n n 5 n T T T T T T T T T T T T T T T T 8 9 8 T T T n n n n n n n
n n 5 1 n n n T 8 9 n n n n n 0 n n n n n n n n n n n n T n n n n n n n
n n n n n n n T 5 n n n n n n n n n n Q W W W W W W W n T n n n n n n n
n n n n n n N T n 1 P n n n n n n 8 n A 1 n n n n n n D T n n 8 n n 0 n
n 9 n n n n n T 1 2 n n n n n n 9 5 n A n S S S S B n D T n n n n 9 n n
n n n n n n n T n n n n n n N n n n n A n S S S S n n D T n 6 n N n n n
n n n n 2 n n T n n n n n n n n 1 n n A n n n n 8 n 2 D T n n n n n n n
n 5 n n n n n T n n n n n n n n n n n Z X X X R X X X C T n n n n 2 n n
n n n n n n n T n n n n n n 9 n n n n n n n n n n n n n T M 3 n n n n n
n n n n n n n A n n n n n 5 n 8 n n n n n n n n n n n 7 T n n n n n n n
n n 8 n n 7 n A n n n n n n n n n n n n n V n n n n n 4 T n 9 n n n 7 n
n n n n n 4 n A n n n n n n n n n n n n 1 n n n n n n n T n n n n n 4 n
n n n n n n n A n n n n n n n n n n n n n n n n n n n n T n n n n n n n
n 6 n n n n n A n n 6 n n S S S n n 7 n n n n n n n n n T 6 n n n n n n
n n n n 1 n 7 A n n n n n S S S n n 4 n N n 8 n n n n n T n n n 1 n 5 n
n n n n n n 4 T n n n n n n n n n n n n n n n n n 2 n n T n n n n 2 n n
n n 9 n 0 n n T 7 n n n n n n n n n n n n n n n 2 1 n n T n n n n n n n
n n n n n n 5 T 4 n B n n n n 2 n n n 6 n n n n n n B n T N n n n 0 n n
n n n 0 n n n T n n n n n n n n 2 n n n n n n S S S n 3 T n n n n n n n
n n n n n n n T n n n n n n n n n n n n n F n n n n n n T n n n n 3 n n
n n n n n n n T n 0 n n 3 n n n n n n n n n n n n n n 0 T n n 9 n n n n
n n n n n n n T T T T T T T T T T T X X X X T T T T T T T n n n n n n n
n n n n n n n n n n n n n 0 n n n n n n n n n n n n n n 8 n n M n 8 n n
n n 1 n n n n n n n n n n n n n n n n n n n n n n n n n n n n n n n n n
n n n n n n n n n 3 n 8 n n n n n n n n 7 n n n n n 6 n n n n n n n n n
n n n n n n n n n n M n n n n n 1 n 7 n 4 n 2 n n n n n 9 n n n n N n n
n n n n n 5 n n 0 n n n n n n n n n 4 n n n n n 5 n n n n 8 n n n n 3 n
n n n 9 n n n n n n n 5 n n n n n n n 0 n n n n n n n n 6 n n 2 n 5 n n
n n n n n n n n n n n n n n n n n n n n n n n n n n n n n n n n n n n n