n n n n n n n n n n n n n n n n n 7 n n n n n n n n n n n n n n n n n n
n n n n n n n n n n n n n n n n n 4 n 8 n n n n n n 1 n n n n 6 n n n n
n n n 8 n n 8 n n n n n n n n n n n n 3 n n n n n n n n n 8 n n n n 9 n
n n n n n n n n n n n n 1 n n n n n n n n n n n 7 n n n n n n n n 5 n n
n 8 n n n n n n n n n n n n n 5 n n n n 3 n n n 4 n n n n n n n n n n n
n n n n n n n n n n n n n 0 n n n n n n n n n n n n n n n n n 1 n n N n
n n n n n n n n n n n n n n n n n n 1 n n n 0 n n n n n n n n n n n n n
n n n n n 5 n Q W W W W W W W W W W W W W W W W W W W W E n n n n n n n
n n 5 1 n n n A Q W W W W W E 3 n n n n n 5 n n n n n n D n n n n n n n
n n n n n n n A A 1 n n n n D n 8 n P 1 n n n V B n n 1 D n n n n n n n
n n n n n n N A A n S S S n D n 5 9 n 1 n n n n n n n n D n n 8 n n 0 n
n 9 n n n n n A A n S V S n G n n n n n n n n n n n 2 n D n n n n 9 n n
n n n n n n n A A n S S S n D n n 2 n n n n n n M n n n D n 6 n N n n n
n n n n 2 n n A A 2 n n n M D n n n n n 8 n n n n n n n D 3 n n n n n n
n 5 n n n n n A Z X X X X X C n n n n n n n n n 1 n n n D n n n n 2 n n
n n n n n n n A n n n n n n n n 2 n n n n n n n n n n 2 D M 3 n n n n n
n n n n n n n A 2 n 5 n n n n n n n n n n n n Q W W W E D n n n n n n n
n n 8 n n 7 n A n n n n 1 n n n n n n n n n n A n n n D D n 9 n n n 7 n
n n n n n 4 n A 0 n B n n n n n n n n n 1 n n A n S n D D n n n n n 4 n
n n n n n n n A n n n n n n n n 3 n n n n 3 n R n F n D D n n n n n n n
n 6 n n n n n A M n n 3 3 3 N n n 9 n n n n n A 5 8 1 D D 6 n n n n n n
n n n n 1 n 7 A 5 n n S S S 9 n 8 8 n n 5 n n Z X X X C D n n n 1 n 5 n
n n n n n n 4 A n M n S S S n n n n n N n 3 n n n n n n D n n n n 2 n n
n n 9 n 0 n n A n n n 8 5 9 n n n n n n n n n n n n n 7 D n n n n n n n
n n n n n n 5 A n 1 n n n n n n n 1 n n n n n n 2 n 1 4 D N n n n 0 n n
n n n 0 n n n A 7 n n n B n n n n n n n 5 2 B 1 n n n n D n n n n n n n
n n n n n n n A 4 1 n n n n n n 0 n n n n n n 8 n n n n D n n n n 3 n n
n n n n n n n A n n 0 n N N n 7 n n n n n n n n n 0 n n D n n 9 n n n n
n n n n n n n Z X X X X X X X X X X X X X X X X X X X X C n n n n n n n
n n n n n n n n n n n n n 0 n n n n n n n n n n n n n n 8 n n M n 8 n n
n n 1 n n n n n n n n n n n n n n n n n n n n n n n n n n n n n n n n n
n n n n n n n n n 3 n 8 n n n n n n n n 7 n n n n n 6 n n n n n n n n n
n n n n n n n n n n M n n n n n 1 n 7 n 4 n 2 n n n n n 9 n n n n N n n
n n n n n 5 n n 0 n n n n n n n n n 4 n n n n n 5 n n n n 8 n n n n 3 n
n n n 9 n n n n n n n 5 n n n n n n n 0 n n n n n n n n 6 n n 2 n 5 n n
n n n n n n n n n n n n n n n n n n n n n n n n n n n n n n n n n n n n