T T T T T T T T T T T T T T T T T T T T
T e e e e e e e e e e e e e e e e e e T
T e e Q W W W W E e e e e e e e e e e T
T e e A S S S S D e e e e e e e e e e T
T e e A S S S S D e e e e e e e e e e T
T e e Z X R X X C e e e e e e e e e e T
T e e e e e e e e e e e e e e e e e e T
T e e B e e e e e F e e e e e e e e e T
T e e e e e e e e e e e e e e e e e e T
T e e e e P e e e V e e e e e e e e e T
T e e e e e e e e e e e e e e e e e e T
T e e e e e e e e e e e e e e e e e e T
T e e e e e e e e e e e e e e e e e e T
T e e e e e e e e e e e e e e e e e e T
T e e e e e e e e e e e e e e e e e e T
T e e e e e e e e e e e e e e e e e e T
T e e e e e e e e e e e e e e e e e e T
T e e e e e e e e e e e e e e e e e e T
T e e e e e e e e e e e e e e e e e e T
T T T T T T T T T T T T T T T T T T T T