n n n n n n n n n n n n n n n n n 7 n n n n n n n n n n n n n n n n n n
n n n n n n n n n n n n n n n n n 4 n 8 n n n n n n 1 n n n n 6 n n n n
n n n 8 n n 8 n n n n n n n n n n n n 3 n n n n n n n n n 8 n n n n 9 n
n n n n n n n n n n n n 1 n n n n n n n n n n n 7 n n n n n n n n 5 n n
n 8 n n n n n n n n n n n n n 5 n n n n 3 n n n 4 n n n n n n n n n n n
n n n n n n n n n n n n n 0 n n n n n n n n n n n n n n n n n 1 n n N n
n n n n n n n n n n n n n n n n n n 1 n n n 0 n n n n n n n n n n n n n
n n n n n 5 n T T T T T T T T T T T T T T T T 8 9 8 T T T n n n n n n n
n n 5 1 n n n T Q W W W W W E 3 n n n n n 5 n n n n n n T n n n n n n n
n n n n n n n T A 1 n n n n D n 8 n P 1 n n n V B n n 1 T n n n n n n n
n n n n n n N T A n S S S n D n 5 9 n 1 n n n n n n n n T n n 8 n n 0 n
n 9 n n n n n T A n S V S n G n n n n n n n n n n n 2 n T n n n n 9 n n
n n n n n n n T A n S S S n D n n 2 n n n n n n M n n n T n 6 n N n n n
n n n n 2 n n T A 2 n n n M D n n n n n 8 n n n n n n n T 3 n n n n n n
n 5 n n n n n T Z X X X X X C n n n n n n n n n 1 n n n T n n n n 2 n n
n n n n n n n T n n n n n n n n 2 n n n n n n n n n n 2 T M 3 n n n n n
n n n n n n n A 0 n 5 n n n n n n n n n n n n Q W W W E T n n n n n n n
n n 8 n n 7 n A 0 n n n 1 n n n n n n n n n n A n n n D T n 9 n n n 7 n
n n n n n 4 n A 0 n B n n n n n n n n n 1 n n A n S n D T n n n n n 4 n
n n n n n n n A n n n n n n n n 3 n n n n 3 n R n F n D T n n n n n n n
n 6 n n n n n A M n n 3 3 3 N n n 9 n n n n n A 5 8 1 D T 6 n n n n n n
n n n n 1 n 7 A 5 n n S S S 9 n 8 8 n n 5 n n Z X X X C T n n n 1 n 5 n
n n n n n n 4 T n M n S S S n n n n n N n 3 n n n n n n T n n n n 2 n n
n n 9 n 0 n n T n n n 8 5 9 n n n n n n n n n n n n n 7 T n n n n n n n
n n n n n n 5 T n 1 n n n n n n n 1 n n n n n n 2 n 1 4 T N n n n 0 n n
n n n 0 n n n T 7 n n n B n n n n n n n 5 2 B 1 n n n n T n n n n n n n
n n n n n n n T 4 1 n n n n n n 0 n n n n n n 8 n n n n T n n n n 3 n n
n n n n n n n T n n 0 n N N n 7 n n n n n n n n n 0 n n T n n 9 n n n n
n n n n n n n T T T T T T T T 4 T T X X X X T T T T T T T n n n n n n n
n n n n n n n n n n n n n 0 n n n n n n n n n n n n n n 8 n n M n 8 n n
n n 1 n n n n n n n n n n n n n n n n n n n n n n n n n n n n n n n n n
n n n n n n n n n 3 n 8 n n n n n n n n 7 n n n n n 6 n n n n n n n n n
n n n n n n n n n n M n n n n n 1 n 7 n 4 n 2 n n n n n 9 n n n n N n n
n n n n n 5 n n 0 n n n n n n n n n 4 n n n n n 5 n n n n 8 n n n n 3 n
n n n 9 n n n n n n n 5 n n n n n n n 0 n n n n n n n n 6 n n 2 n 5 n n
n n n n n n n n n n n n n n n n n n n n n n n n n n n n n n n n n n n n