n n n n n n n n n n n n n n n n n N n n n n n n n n n n n n n n n n n n
n n n n n n n n n n n n n n n n n n n 7 n n n n n n 1 n n n n 6 n n n n
n n n 2 n n 8 n n n n n n n n n n n n 4 n n n n n n n n n 8 n n n n 9 n
n n n n n n n n n n n n 1 n n n n n n n n n n n 7 n n n n n n n n 5 n n
n 8 n n n n n n n n n n n n n 5 n n n n 3 n n n 4 n n n n n n n n n n n
n n n n n n n n n n n n n 0 n n n n n n n n n n n n n n n n n 1 n n N n
n n n n n n n n n n n n n n n n n n n n n n 0 n n n n n n n n n n n n n
n n n n n 5 n Q W W W W W W W W W W W W W W W W W W W W E n n n n n n n
n n 5 1 n n n A 8 9 n n n n n 0 n n n n n n n n n n n n D n n n n n n n
n n n n n n n A 5 n n n n n n n n n n Q W W W W W W W E D n n n n n n n
n n n n n n N A n 1 P n n n n n n 8 n A 1 n n n n n n D D n n 8 n n 0 n
n 9 n n n n n A 1 2 n n n n n n 9 5 n A n S S S S B n D D n n n n 9 n n
n n n n n n n A n n n n n n N n n n n A n S S S S n n D D n 6 n N n n n
n n n n 2 n n A n n n n n n n n 1 n n A n n n n 8 n 2 D D n n n n n n n
n 5 n n n n n A n n n n n n n n n n n Z X X X R X X X C D n n n n 2 n n
n n n n n n n A n n n n n n 9 n n n n n n n n n n n n n D M 3 n n n n n
n n n n n n n A n n n n n 5 n 8 n n n n n n n n n n n 7 D n n n n n n n
n n 8 n n 7 n A n n n n n n n n n n n n n V n n n n n 4 D n 9 n n n 7 n
n n n n n 4 n A n n n n n n n n n n n n 1 n n n n n n n D n n n n n 4 n
n n n n n n n A n n n n n n n n n n n n n n n n n n n n D n n n n n n n
n 6 n n n n n A n n 6 n n S S S n n 7 n n n n n n n n n D 6 n n n n n n
n n n n 1 n 7 A n n n n n S S S n n 4 n N n 8 n n n n n D n n n 1 n 5 n
n n n n n n 4 A n n n n n n n n n n n n n n n n n 2 n n D n n n n 2 n n
n n 9 n 0 n n A 7 n n n n n n n n n n n n n n n 2 1 n n D n n n n n n n
n n n n n n 5 A 4 n B n n n n 2 n n n 6 n n n n n n B n D N n n n 0 n n
n n n 0 n n n A n n n n n n n n 2 n n n n n n S S S n 3 D n n n n n n n
n n n n n n n A n n n n n n n n n n n n n F n n n n n n D n n n n 3 n n
n n n n n n n A n 0 n n 3 n n n n n n n n n n n n n n 0 D n n 9 n n n n
n n n n n n n Z X X X X X X X X X X X X X X X X X X X X C n n n n n n n
n n n n n n n n n n n n n 0 n n n n n n n n n n n n n n 8 n n M n 8 n n
n n 1 n n n n n n n n n n n n n n n n n n n n n n n n n n n n n n n n n
n n n n n n n n n 3 n 8 n n n n n n n n 7 n n n n n 6 n n n n n n n n n
n n n n n n n n n n M n n n n n 1 n 7 n 4 n 2 n n n n n 9 n n n n N n n
n n n n n 5 n n 0 n n n n n n n n n 4 n n n n n 5 n n n n 8 n n n n 3 n
n n n 9 n n n n n n n 5 n n n n n n n 0 n n n n n n n n 6 n n 2 n 5 n n
n n n n n n n n n n n n n n n n n n n n n n n n n n n n n n n n n n n n