n n n n n n n n n n n n n n n n n 7 n n n n n n n n n n n n n n n n n n
n n n n n n n n n n n n n n n n n 4 n 8 n n n n n n 1 n n n n 6 n n n n
n n n 8 n n 8 n n n n n n n n n n n n 3 n n n n n n n n n 8 n n n n 9 n
n n n n n n n n n n n n 1 n n n n n n n n n n n 7 n n n n n n n n 5 n n
n 8 n n n n n n n n n n n n n 5 n n n n 3 n n n 4 n n n n n n n n n n n
n n n n n n n n n n n n n 0 n n n n n n n n n n n n n n n n n 1 n n N n
n n n n n n n n n n n n n n n n n n 1 n n n 0 n n n n n n n n n n n n n
n n n n n 5 n T T T T T T T T T T T T T T T Q W W W W W E n n n n n n n
n n 5 1 n n n T 1 n 8 9 n n n n n n n n n n A n 1 n n n D n n n n n n n
n n n n n n n T 1 n n n n n n n n n n n n n A n S F S S D n n n n n n n
n n n n n n N T n B n n n n S S S S S n n n A n S S S n D n n 8 n n 0 n
n 9 n n n n n T n n n 5 n n S S S S S n n n G n S S S n D n n n n 9 n n
n n n n n n n T n n n n n n n n n n n n n n A n n n 2 n D n 6 n N n n n
n n n n 2 n n T n n n n n n 7 n n n n n n n Z X X X X X C 3 n n n n n n
n 5 n n n n n T n n 9 S n n 4 n n n n n n n n n n n n n T n n n n 2 n n
n n n n n n n T n n S N n n n n n n n n n n n n n n 5 1 T N 3 n n n n n
n n n n n n n T n S n n n n n n n n n 5 n n n n n N n n T n n n n n n n
n n 8 n n 7 n T n n P n n n n n n 1 n n n n n n n n n n T n 9 n n n 7 n
n n n n n 4 n T N n n n n n n 9 n n n n n n n n n B n n T n n n n n 4 n
n n n n n n n 3 1 N N n n n n n n n n n n n 1 n n n n n T n n n n n n n
w w w w w w w w w w w w e n n n n V V V 2 n n n n n n n T 6 n n n n n n
s s s s s s s s s s s s d n n n n n n n n n n n n n n n T n n n 1 n 5 n
s s s s s s s s s s s s d Q W W W W E n n n n n n n n n T n n n n 2 n n
s s s s s r s s s s s s d A n n n n D n n n n n Q W R W E n n n n n n n
s s s s s s s s s s r s d A n S S n D n n n n n A n n n D N n n n 0 n n
s s s s s s s s s s s s d A n S S n G n n B B n A N S n D n n n n n n n
s s s s s s s s s s s s d A B S S n D n n n n n A n S n D n n n n 3 n n
s s s r s s s s s s s s d A n n n n D n 8 n n n A n n n D n n 9 n n n n
s s s s s s s s s s s s d Z X X X X C 0 0 X T T Z X X X C n n n n n n n
s s s s s s s s s s s s d 0 n n n n n T T n n n n n n n 8 n n N n 8 n n
s s s s s s s r s s s s d n n n n n n n n n n n n n n n n n n n n n n n
s s s s s s s s s s s s d n n n n n n n 7 n n n n n 6 n n n n n n n n n
s s s s s s s s s s s s d 3 n n 1 n 7 n 4 n 2 n n n n n 9 n n n n N n n
s s r s s s s s s s s s d n n n n n 4 n n n n n 5 n n n n 8 n n n n 3 n
s s s s s s s s s r s s d n n n n n n 0 n n n n n n n n 6 n n 2 n 5 n n
s s s s s s s s s s s s d n n n n n n n n n n n n n n n n n n n n n n n