1 1 1 1 1 1 1 1 1 1 1 1 1 1 1 1 1 1 1 1
1 1 1 2 1 1 1 2 2 1 2 1 1 1 1 1 1 1 1 1
1 1 1 Q W W W W E 1 1 1 1 1 1 1 1 1 1 1
1 1 2 A S S S S D 1 1 1 1 1 1 1 1 1 1 1
1 1 1 A S S S S D 1 2 1 1 1 1 1 1 1 1 1
1 1 1 Z X S X X C 1 1 1 1 1 1 1 1 1 1 1
1 2 2 1 1 F 1 2 1 1 1 1 1 1 1 1 1 1 1 1
1 1 T Y Y H Y Y Y U 2 1 1 1 1 1 1 1 1 1
1 1 2 1 1 F 1 1 1 1 1 1 1 1 1 1 1 1 1 1
1 1 1 1 1 Z Y Y Y Y U 1 1 1 1 1 1 1 1 1
1 1 1 1 1 1 1 1 2 1 2 1 1 1 1 1 1 1 1 1
1 1 1 1 1 1 1 1 1 1 1 1 1 1 1 1 1 1 1 1
1 1 1 1 1 1 1 1 1 1 1 1 1 1 1 1 1 1 1 1
1 1 1 1 1 1 1 1 1 1 1 1 1 1 1 1 1 1 1 1
1 1 1 1 1 1 1 1 1 1 1 1 1 1 1 1 1 1 1 1
1 1 1 1 1 1 1 1 1 1 1 1 1 1 1 1 1 1 1 1
1 1 1 1 1 1 1 1 1 1 1 1 1 1 1 1 1 1 1 1
1 1 1 1 1 1 1 1 1 1 1 1 1 1 1 1 1 1 1 1
1 1 1 1 1 1 1 1 1 1 1 1 1 1 1 1 1 1 1 1
1 1 1 1 1 1 1 1 1 1 1 1 1 1 1 1 1 1 1 1