0 0 0 0 0 0 0 0 0 0
0 0 Q W W W W E 0 0
0 0 A S S S S D 0 0
0 0 A S S S S D 0 0
0 0 Z X 0 X X C 0 0
0 0 0 0 0 0 0 0 0 0
0 0 0 0 0 0 0 0 0 0
0 0 0 0 0 0 0 0 0 0
0 0 0 0 P 0 0 0 0 0
0 0 0 0 0 0 0 0 0 0