0 0 0 0 0
0 Q W E 0
0 A S D 0
0 Z 0 C 0
0 0 5 0 0
0 0 2 0 0